#########################
#.......................#
#.......................#
#...........#...........#
#...###...........###...#
#.......................#
#.......................#
#...###...........###...#
#.......................#
#..@........N...........#
#.......................#
#...###...........####..#
#.......................#
#.......................#
#...###...........####..#
#...........#...........#
#.......................#
#.......................#
#########################