#########################
#B.....................k#
#.........s.............#
#.......................#
#@......................#
#.......................#
#.......................#
#B........s............k#
#########################