#########################
#.......................#
#.......................#
#.......................#
#...........@...........#
#.......................#
#.......................#
#.......................#
#########################
