##############################
#............................#
#............................#
#............................#
#............................#
#............................#
#..............@.............#
#............................#
#............................#
#............................#
#............................#
#............................#
#............................#
##############################